8 15
|-------------|
|..F.|..-.....|
|...-|.@.P.-..|
|..F....-.....|
|...-......-..|
|...P..-......|
|-------------|